01100001111101001100011100110101111011101100010010111001100001110111101100010010010011011010011101001000011011101101011100000001
00011011011111011010000100010100100100101000010101000000001000110001111010000000000001111001110000111111110111100111001000110001
00000101011011010010111110111100011010101011110111110010001101111010100001111101010001101111101110101011101001000011000010111110
11011110101110111000001110010111000011100101111100001000100010111101101100101011011111000100000101100010111000001101011100111011
00000100100010110000011010110111001000000111011011011110010010011101100111001101000001011010010001110101100101001110001001001001
01100111011010100011101111100001010010101010011111101101101001011101011101100011011110100101101000000110000010101100011000101100
10110001111111101010011110000000110100001000101010101101000101100100110111010110001101100000100010010110000101111110101101000110
00110110000001100101011011010111001101011111010011000010010110000011111011010111101011010111101100001010111110011110100011001110
01000111111101001001010101111011001101010110001001111111011110000011001101011000100100001001111110110011000101101000001101001111
10001011100111111101110000110001010111100101111011000001101010100001000001101000001000110110100111100001010000000001101000011011
11101101011100010100111011011000001001101110110001110010001011110101111010100001000000001100100001101010001010001100111100100111
01010110011111001010011111000101111110011000101010001111011011011100000011111111101110010011110101111000011011111101001010100111
11000010000110111100101110101000000000101111000010101010000100001000000100100111000010101000011101010001010000011100110100000100
11000101010010001111111000111001010111110101111010000111110100010110000100011101000011000011001001100111010100011010010111001100
01000000000011111010011001001101011100000100101000011010000001111001110110101010100010111001100010001100101010100100000111000000
11000110000100001000000001011001010110110000011000101110001001011111001100001111000100110111000100000111001010111101011000111101
11111001101001001010100111100011101110101000010011110001110110100101001111100011100011101111010110001110111000111000010000100000
10001101001011110101011011110100001101110111111010100011000110110000011001101011101000001110010111001110111111010010011011001100
00000010010100110000100010001001011100101000011111000010100111100110001011000010011001111110001101111011111001011101000000010011
11010011001110010100111001111010001010001011001001110101101100001011001101101000110011011010000011000101111101111011011110110010
11110110101100101010011001101101110101001000100101010101011110010111110100010011001100101111010000011001000001110110000100101001
00110001011100001111000110100000100111110100100001000111100111001101111001000010101110100010011000111101000001111111000011010110
00110000011111001000001101000111110100001111111110110110001011000010010011000000111101101010011100111100001101100000110110001111
10011001101011011001101110001010100110110001100111010111011010011101110101000111111110110100010100000110001001010110011001111000
10110011100011101001001001001001101111101101010111110100011010001111100100101001100010101001000101001000101001011011011010000001
00001010000000000110101100100001100111010101101000110100001111011110111101000000011100111111100000010001000001101110110101010000
10000111000110001110101001000000101001100111111011001010100111000010111001101010010110011111111110010100010100111001101100000101
10110110000011001011111011110100111000001101101011010000000010111000111110011100010001101000111000111011000010101110001000011001
10011100000001101101001001110111001001100010010000010100111100100010010100110110000000101111101000010001011100110101100000001010
01010100110001010110001111000011110111010101101111101110000110000110001101010111001101011101111001001010001110101110100000000110
00000100011101001110100101011010001110001100000110010101000011100010110101101000111100110100101010100000000000000111110010000001
01001000100010100010011011001111001101101010101000100100110110111000001011011111101001111010111011000110010010100100010011010100
00011001100011101111100111001011001011100001111000101011001011110111100100001110100010010111000000001110101010100010001110011000
11001100100011000011011100100011010100101001010100001001100011100000100110000110100101101010111011100111101111010100000110111000
01110011000110100001001101011000110001100011110101101001100110001010111001001101001110100101011111101100110011110110001111100110
01010011000111100011001111111111110101100001110011110011111000011001111100100111001110001000000100001011011011101001111010100011
01101101100110111100011101111010101100111011010000011110110011010010010011001000000010111101001000000000110001000010110101000011
01111010100101100000111101100010011010000111000100100100110001110111111101001101110100001000110011110110010100010010101010011000
11101110100101110010000110100101011011101011101011100001111101101010000100001100110110001001100011001101111100000100010010101010
10000100010100000111011100010011110100010100110011011011110111010001010011100001111011001011100111010101001001010111010000001111
11001101000000101010100110110110101110010001101101110101000110111000111100111101100010101111011110101110010100000110110001000001
01010000110001111110110110101111000011101111111011001101101001011010101110111001000000101011001101001001010100010111001010000100
10000010110101110011110101101110100111101010010010000100110000101011101100000000011111010010100000010101001111001000011100111010
01000111101010101010111001110110001101111000111001001111100000001100111011000011111111111001101100010110111111010011010111110100
11001101100111010110111010111010001010010101001011110000100111110101000001100110111100000010110101010010001101000001000100001100
11001111011011011001000010000011101001000000100010111110100100110010101010010101111100000110110011101111011110101000100000001110
01111101101011000100100000101111110011001100001100011110101110111111110010000101100001001110011001110001111100010100110111001010
10000011010111100101110100000011110111001100111101101100011100110001001000001010011011010000001100100000100111011010100011101100
00110100110111001010001010111111000010000111000100111110001111000101100100000111111110101001001101000101010110110111011111010000
01010010011101001111111000001110100111001100010110010010100000000110011110110111110011001111100101100001100011111100010101010011
10111011100000101101101001110101101011110110000010111101100001001111101110111010100010111101000011001111111011010001010001001100
11001101000111000101011100111010010010110111101010010110011010011000011100101100111000100010000001001001011011111011001010001111
00100110111100011101010111001110010000111001011100111101011001100100100101101001100000011111101110101000111011011010011111111011
10111001011001011010010001001101100111111000010011101000000000110111111111100110101111000101111100000111110110000001011001110110
10000110101100010011111000111111111110101101100110101010010111001100111010000110111111011001000101010011000111011011010100111100
01010101000111001111100001000100101110000111011101001011000100110011011001001001000100010000000110011100111101100001010001110011
01010010000000100111101100100110011111100100001100000101110001100101010101010101110101000111011110110100111110110101101101000100
11101001000011010101100000100000001100101000001110111111000101111101100001111110010000110001111100000000110001001000110100110110
10011000101010010111010101111110011100010011000001001011101100101010111101111001001000110111010101000111111101000000101110111010
11111010010110000010100010010110010011000100101101101100100111000111001001110001100101011010011101101000001000111000000100010000
11010100000111100010010001000100100101110010000110110111101101100111101011001110110100101101010010001000100001100011110110011100
01011110100101010101000011100110010101101001110100000011100000001010010110101110111100000010111101010001001100100111010111110111
01101011001001000001100010010101011110101000111010101101000100110101010110111000110010111011001010010010001101100101001011101010
11111101010101010110101011010111111000011011111100101000001000010110010110001001101111001001110111000111111010000101001011110010
10111110011000011011010001011000000101111001110010011000010110100111100111001100101110000111011110011000110110011011000011110001
10110100000110101011100101110010010101101001101101001011101110101011001111000000101010110001001010100110001100001001110110011000
01110110101100001111000111000001100010110011011001010001110001101111100110000110000010001010101001100101011010110110010101101010
11101110001011000111111110110110100100111101101110001000011111011010101000001111011010010100010110000011100100000110101001000110
11001110011111100010100110001111110101010011010001101110110111011111011110001110100110111101011011101001001111010000001110100111
11100010100101101010000011100011101011111011111111010010111010111011001100101111110001010000100000111011110101011001000100110000
10110000001101100101101010111010010001110100011100111111101000100010111010010101001010101101100111111100110010001001101100011100
11101111100001000111111111100010001111101110000100110010110100001011100011100101110001110001011010110110100000010111101100001011
10001101111101001000000010001110010101001000011000100101011100111111011101001000010110101011100111111100000001010000010101010011
01110011100111110001100100111011010001000001100101000101011111010111101110000110011110011010110001011010000111101110010000100011
01011011110110011110011100001000001010001010100100000111001111100001001100001000111010110011111010111000111011011011101011110100
11111001101100110101100110011000100100011000110000000010011010100100101101010110011001010001000111011000011000001001000010111111
00001101101110111111011100001101001111010001011100001110111010000010111010001001010110001000111101011000011110011011100001101001
11101011001101110100011100110111011110001100100000001010100101011000001100010100100111101101000111011011000111000110101011110110
00100101001100111001101010100111110000000010001001100111110001100101101101010001110110010100101001110001101110000111101101000011
01110100010001111110110110001001001100001001011011111101100001001011001100100010101000100110111001100000000100101000111000101001
11000111111001100011110110101000110011111100010011111100000100111101011001010101010101011100000010101001011110010010110110111011
10100000011110000010110011100111101011110101100001000010110000011101111111110011111000111001101100000000110100111000110001101100
00011010011010010000100011011001010010110101110110001101001001011010101111100110001110000110110001011001101011000101001010100010
10100100011111111001111111001101001000001011100100000101110110110010101101101101111101100101011110010000001010101010101000111001
00011111010101101001101101011011100011010100001101000110100101001011111000011101110001001101101111000100100100001111101110000110
11111100011000110010110110101000110111100001011100100011100100111111110111101110010010010100101100010001000001110111100100011101
01111111101011111110010100001101110010010100001101111001010010111101111110100101000000110010100110011010110110010010000010110011
10011100101111011110101001101101111011101001111100100000100100001011111111100001001000100001000111110001010111010000110010101010
01111010111100100001001110111010000001000101110001010010010111000100101001001000100010010011010010110101100000101101011000101001
01010001111000001110011010110000111001000110100010000110011000100111010111110110010011101100010110100110000000010110111101001111
01011011101100111101010001010101001111100101100011011000010101101100101101011111111100101111101000100000101010100010101110111100
10011111011101110100001101100100110011000101110011000010011110000111100011101100001010111111011100001010100100000110100001011111
11011001000100011110011010100000101101001001001000011011101110000100100001011111001010000010010011101011001100011110000100101011
00110100100111011011101011100110010101100010111101010111000010010110000011000011111010010001111100001110101110101000000010110011
00100000101110110100001010010111000010011000110110010101010001011010010100100100100000100011010010110001001001100100000111111011
00000011001000111100010111101011110000010010001101100001111001100101000110100111111111011011110000011001111111110000110000110110
01111000101011000000001100100110100000101110111101001010110011100010101110100010010000101001011001000000100100100000011010010001
11011010011011110011111110010110101010100010010000111100011010000000010110001001110010100110001011001011000011111111111011011000
00110010001110011110011111010100100111010111011010010001010001110110110100110011001100010111111100110100101100100000111010011101
00010001011000000010011100110111010100000100101010010111101001011100100000111101000011000000000010101000101000100101010111101111
11000001000010110001100010001010111100011111000010111101110001001110010101111111111010011110011100011000101101101001111010000100
01011100110001000100000011010011101111100010100001100100001111001100011110010001011100110001101111001011101100000100100111001001
00100010010000100110010111100111001110000100101001000110000010110100111100001111000001111111100101111000010110100101001000010011
10101101011001101110011110001000111101001011001010101000001111111100110100110000101111110000011110001111000001111111011001001110
11111001110100111111100011001101100111000001100110110101010110100111010001101100101001100011000100100011100011110011111001101000
10010010010101011111001111100001111010110110011100010110000110011011001011111000000000111000101100001000101001111011101110000000
00000101010001110000000111101001000001100000100001010101001000000110000100011101101100100100011010101000100100010111011000010110
01110000010001011000110100011001111111011010001001101100110111100010111101111111011011011101111000011001101010111000000110011100
11101000111000010001101000111000101111000111011001111001111000001110010111001000010001001101000000101001111110000110111001111110
01100000010111100001111100110011000001110011101100010110101100100001001101011010000000011001000000111000010010110011010100010100
11111010101110101011111011110100011011100100000010101010101110001001010011000110001000101111000000111011011010110111111110011001
01111100011100101010110001001100010111100000110100000000110110001011010110010111111110110100010000001010111010101110000111111001
10001110001001000110110000110100010001111111011110110110000000001001010001100100001100101111011000000011100000000111111100111100
00010000110001110101110100100111110110111001111001000011100010111001110111010100111010100001000100110111001010100000010110001010
10001001000010010010010101011110010001001101011100001010001001000110100110000001000100101101101000100100111110000000110110110111
01001111101000000011010011011011111110011101011111000000110011111000100110111000111011010000011001110100001111010000010110110111
10101010110010000100001001101011001000111011000110101110110110111011110110011101100010111010000111100011011101010100010101110101
10010100001110111101100011101100111011000001101001000001101010110001001000110000110111100111100100011111100100010001100110010101
10001011110010110101100101100000000010010100101000011000110111011111110011100110100011100011101010001010010110000111010111110110
01010010100101000110110110000100000011001100101000001100000111111100010100000010000101111001100010111111100111101101000001000011
10000100011110010101110000101100101111011100010100010010010101100101001001111101100110100100001000010100101000011010010001010111
00001001000000000001000000100101010100001010111100000000110101000101100100101110001000011001100111101110110101001011101101011001
11110011101001111000010100100101001000110001001111101011110110011100000001010000000101000010111010110110011110010000011010010101
00001111010001111000111000001010101001011000010001101010000100100010001101110100100100110001001000111111100001101100111100110101
01010010101011011101000011011110010011111010011000101101010011100010101110101000010111100111101001011011010011101111101000110011
00001100001001000101101110110110100100011001101111110111110011100101111101010101101111000011101110001001011110000001100010010010
10000001000111100011010111010111010100010111100011100000001011110011000001101000100011101011000111010011100000100110101111000110
01100111001110010101111110010010011100100011100000000000011011100010011011010101010110111111010010111010000101101110110110101010
